2 0 5 12 11 12 0 0 0 0 0 
1 1 1 1 1 1 1 1 1 1 0 
9 0 14 4 0 1 9 5 9 1 0 
5 14 8 1 0 1 9 5 9 1 0 
1 4 1 1 0 1 1 1 13 1 0 
5 16 0 1 0 4 15 11 17 1 0 
7 0 5 1 0 1 1 1 1 1 0 
1 4 1 1 0 0 0 0 0 0 0 
0 16 0 1 1 4 1 1 1 4 1 
9 10 5 1 5 0 0 1 5 19 5 
9 8 5 1 0 0 0 1 5 5 5 
