3 1 0 19 0 1 8 7 5 5 1 
0 1 7 1 10 1 8 7 5 5 1 
0 1 5 1 5 1 8 7 5 16 1 
0 1 5 1 5 1 1 1 1 4 1 
0 1 0 1 0 0 0 4 0 0 1 
0 1 4 1 1 4 1 1 4 1 1 
0 1 0 0 0 0 1 0 16 0 1 
0 1 4 1 1 4 1 4 1 4 1 
0 1 5 1 10 9 1 0 1 0 1 
0 1 5 1 10 9 1 0 1 0 1 
2 1 8 1 10 9 1 0 1 0 1 
