8 12 5 1 6 6 6 1 1 1 1 
12 5 0 1 0 0 0 1 0 17 0 
5 14 0 1 1 4 1 1 0 1 0 
1 4 1 1 0 14 0 1 5 1 12 
0 0 0 1 1 1 0 1 5 1 17 
11 1 0 17 11 17 0 1 5 1 12 
11 1 1 1 1 1 0 0 0 1 0 
0 0 0 0 0 1 1 4 1 1 0 
1 1 1 1 17 1 11 0 11 1 0 
1 0 0 0 0 1 7 17 5 1 0 
3 0 1 1 1 1 8 10 5 1 2 
