0 13 0 1 0 0 0 1 0 13 0 
4 1 4 1 0 0 0 1 4 1 4 
0 1 0 1 1 4 1 1 0 1 0 
0 1 14 1 18 19 18 1 14 1 0 
17 1 9 1 7 18 7 1 9 1 17 
17 1 9 1 1 4 1 1 9 1 17 
12 1 0 1 15 16 15 1 0 1 12 
0 1 0 1 8 15 8 1 0 1 0 
0 1 0 1 1 4 1 1 0 1 0 
0 1 0 1 5 0 5 1 0 1 0 
0 1 0 13 0 0 0 13 0 1 3 
